25 22
#############
#...........#    ########
#...s...s...######......#
#....................b..#
#..k........######..b...#
#.....s.....#    #......#
#...........#    #.b..b.#
#.s.........#    #......#
#####..######    ###..###
    #..#           #..#
    #..#           #..#
    #..#          ##..##
  ###..####      #......#
  #..@....#      #......#
  #.......#      #......#
  #.......#      #......#
  #.......#      #......#
  #.......#      #......#
  #.......#      #...l..#
  #########       ######
=========================
!